24
128
F......................F
F......................F
F......................F
F......................F
F......................F
F......................F
F......................F
F......................F
F......................F
F......................F
F......................F
F......................F
F......................F
F......................F
F......................F
F......................F
F......................F
F......................F
F......................F
F......................F
F......................F
F......................F
F......................F
F......................F
F......................F
F......................F
F......................F
F......................F
F......................F
F......................F
F......................F
F......................F
F......................F
F......................F
F......................F
F......................F
F......................F
F......................F
F......................F
F......................F
F......................F
F......................F
F......................F
F......................F
F......................F
F......................F
F......................F
F......................F
F......................F
F......................F
F......................F
F......................F
F......................F
F......................F
F......................F
F......................F
F......................F
F......................F
F......................F
F......................F
F......................F
F......................F
F......................F
F......................F
F......................F
F......................F
F......................F
F......................F
F......................F
F......................F
F......................F
F......................F
F......................F
F......................F
F......................F
F......................F
F......................F
F......................F
F......................F
F......................F
F......................F
F......................F
F......................F
F......................F
F......................F
F......................F
F......................F
F......................F
F......................F
F......................F
F......................F
F......................F
F......................F
F......................F
F......................F
F......................F
F......................F
F......................F
F......................F
F......................F
F......................F
F......................F
F......................F
F......................F
F......................F
F...SSMSS..............F
FFFFFFFFFFFFFFFF.......F
F...............F......F
F................F.....F
F.................F....F
F..................F...F
F......................F
F..............M....M..F
F.......FFFFFFFFFFFFFFFF
F......................F
FFFFFF.................F
F.....F................F
F......F...............F
F.......F..............F
F........F.............F
F.........F............F
F...oooo...............F
FFFFFFFFGGGGFFFFFFFFFFFF
F.........F............F
F........F.......SSSSSSF
F.......F..............F
F..............GG..o...F
FFFFFFFFFFFFFFFFFFFFFFFF
